9
24 1 2 4 5 6 7 8 9 10 12 13 14 16 17 18 19 20 21 22 25 26 28 29 30
17 1 2 5 6 7 12 14 15 18 20 21 22 25 26 27 28 29
28 1 2 3 5 6 7 8 9 10 12 13 14 15 16 17 18 19 20 21 22 23 24 25 26 27 28 29 30
4 4 14 16 23
5 1 6 11 14 16
20 1 2 4 5 6 7 9 15 16 17 18 20 21 23 24 25 27 28 29 30
15 3 5 6 7 9 10 11 15 16 19 21 23 24 25 30
4 4 11 13 24
11 3 5 8 9 10 13 14 17 19 25 29
0
